11111111111111111111111
10000000000100000000001
1000C0000001000000C0001
10000000000100000000001
10000000000111110000001
11110000000000010000001
1EC00000P000000100C0001
11110000000000000000001
100000000000000000C0001
10000000000000010000001
10000111100C00011111111
10C00100000000000000001
1000010000000000000C001
11111111111111111111111
















aushgdbiaushfioua