11111111111
10000000001
10E00P00C01
10000000001
11111111111