11111111111111111111111111111
10000000000000000000001000001
10E0P00C000000000000001000C01
10000000000000000000001000001
1C000111000000000000001000001
10000C0100C000000000000000001
1000000100000000000C000000001
10000001000000000000000000001
100000011110C0000000000000001
10000000001000000000000001111
11111111111111111111111111111