1111111111111
1000000000001
10C0P0E000001
1000000000001
1111111111111